%%%%%
%   %
%   %
%P. % 
%%%%%
