%%%%%
% G.%
%   %
%P. % 
%%%%%
