%%%%%%%%%%%
%. %   .  %
%  %      %
%. %      %
%  %      %
%  %      %
%  %  .   %
%  %      %
%P   ..   %
%%%%%%%%%%%
