%%%%%
% . %
%   %
% . %
% . %
%   %
%  .%
%   %
%P .%
%%%%%
